あ	a
い	i
え	e
う	u
お	o
か	ka
き	ki
く	ku
け	ke
こ	ko
さ	sa
し	shi
す	su
せ	se
そ	so
は	ha
ひ	hi
ふ	hu
へ	he
ほ	ho
ら	ra
り	ri
る	ru
れ	re
ろ	ro
た	ta
ち	chi
つ	tsu
て	te
と	to
な	na
に	ni
ぬ	nu
ね	ne
の	no
ま	ma
み	mi
む	mu
め	me
も	mo
や	ya
ゆ	yu
よ	yo
わ	wa
を	wo
ん	n

が	ga
ぎ	gi
ぐ	gu
げ	ge
ご	go
ざ	za
じ	ji
ず	zu
ぜ	ze
ぞ	zo
だ	da
ぢ	di
づ	dzu
で	de
ど	do
ば	ba
び	bi
ぶ	bu
べ	be
ぼ	bo
ぱ	pa
ぴ	pi
ぷ	pu
ぺ	pe
ぽ	po

きゃ	gya
きゅ	gyu
きょ	gyo
しゃ	sha
しゅ	shu
しょ	sho
ちゃ	cha
ちゅ	chu
ちょ	cho
にゃ	nya
にゅ	nyu
にょ	nyo
ひゃ	hya
ひゅ	hyu
ひょ	hyo
みゃ	mya
みゅ	myu
みょ	myo
りゃ	rya
りゅ	ryu
りょ	ryo
じゃ	ja
じゅ	ju
じょ	jo
びゃ	bya
びゅ	byu
びょ	byo
ぴゃ	pya
ぴゅ	pyu
ぴょ	pyo

ぁ	a
ぃ	i
ぅ	u
ぇ	e
ぉ	o
ゃ	ya
ゅ	yu
ょ	yo
