ア	a
イ	i
ウ	u
エ	e
オ	o
カ	ka
キ	ki
ケ	ke
ク	ku
コ	ko
サ	sa
シ	shi
ス	su
セ	se
ソ	so
ハ	ha
ヒ	hi
フ	hu
ヘ	he
ホ	ho
ラ	ra
リ	ri
ル	ru
レ	re
ロ	ro
タ	ta
チ	chi
ツ	tsu
テ	te
ト	to
ナ	na
ニ	ni
ヌ	nu
ネ	ne
ノ	no
マ	ma
ミ	mi
ム	mu
メ	me
モ	mo
ヤ	ya
ユ	yu
ヨ	yo
ワ	wa
ヲ	wo
ン	n

ガ	ga
ギ	gi
グ	gu
ゲ	ge
ゴ	go
ザ	za
ジ	ji
ズ	zu
ゼ	ze
ゾ	zo
ダ	da
ヂ	di
ヅ	dzu
デ	de
ド	do
バ	ba
ビ	bi
ブ	bu
ベ	be
ボ	bo
パ	pa
ピ	pi
プ	pu
ペ	pe
ポ	po

キャ	gya
キュ	gyu
キョ	gyo
シャ	sha
シュ	shu
ショ	sho
チャ	cha
チュ	chu
チョ	cho
ニャ	nya
ニュ	nyu
ニョ	nyo
ビャ	hya
ビュ	hyu
ビョ	hyo
ミャ	mya
ミュ	myu
ミョ	myo
リャ	rya
リュ	ryu
リョ	ryo
ジャ	ja
ジュ	ju
ジョ	jo
ビャ	bya
ビュ	byu
ビョ	byo
ピャ	pya
ピュ	pyu
ピョ	pyo

ヴァ	va
ヴィ	vi
ヴ	vu
ヴェ	ve
ヴォ	vo
ウィ	wi
ウェ	we
ウォ	uo
ファ	fa
フィ	fi
フェ	fe
フォ	fo
チェ	che
ディ	di
ドゥ	dou
ティ	ti
トゥ	tou
ジェ	je
シェ	she

ァ	a
ィ	i
ゥ	u
ェ	e
ォ	o
ャ	ya
ュ	yu
ョ	yo
